12
77 4 4 4 4 4 4 4 4 4 4 7 7 7 7 7 5 5 9 9 9 9 9 9 9 9 9 4 4 4 4 4 4 4 4 4 4 4 4 4 4 4 4 4 4 4 4 4 12 10 10 14 10 10 16 16 16 16 16 10 10 18 18 18 18 18 10 10 20 20 20 20 20 20 20 20 20 4
17 23 23 24 23 23 23 26 26 26 26 26 26 25 25 28 25 22
35 30 30 31 31 31 31 31 31 31 31 31 30 30 30 33 33 33 33 33 32 32 35 35 35 35 35 35 35 35 35 34 34 36 32 29
24 38 38 38 38 38 38 39 39 39 39 38 38 38 41 40 42 42 42 42 42 42 42 42 42
52 45 45 45 45 46 46 46 46 46 45 45 45 48 48 48 48 48 47 47 47 52 52 52 52 52 51 51 51 53 50 50 50 55 54 49 49 49 56 58 57 57 57 59 59 59 59 59 56 56 56 60 56
48 62 62 62 62 64 64 64 64 64 64 64 64 64 63 63 66 66 66 66 63 62 62 62 68 68 68 68 68 68 68 68 68 68 68 67 67 70 69 69 71 69 69 72 72 72 72 72 67
9 38 38 38 38 38 38 38 38 37
14 74 74 74 74 74 74 74 74 74 74 74 74 74 73
0
1 2
10 76 76 76 76 76 76 76 76 76 75
0
