12
77 4 4 4 4 4 4 4 4 4 4 7 7 7 7 7 5 5 9 9 9 9 9 9 9 9 9 4 4 4 4 4 4 4 4 4 4 4 4 4 4 4 4 4 4 4 4 4 12 10 10 14 10 10 16 16 16 16 16 10 10 18 18 18 18 18 10 10 20 20 20 20 20 20 20 20 20 4
17 23 23 24 23 23 23 26 26 26 26 26 26 25 25 28 25 22
35 30 30 31 31 31 31 31 31 31 31 31 30 30 30 33 33 33 33 33 32 32 35 35 35 35 35 35 35 35 35 34 34 36 32 29
24 38 38 38 38 38 38 39 39 39 39 38 38 38 41 40 42 42 42 42 42 42 42 42 42
34 45 45 45 45 46 46 46 46 46 45 45 45 50 50 50 50 49 49 54 53 52 52 52 55 49 48 48 48 57 56 47 47 47 58
49 60 60 60 60 62 62 62 62 62 62 62 62 62 61 61 64 64 64 64 61 60 60 60 66 66 66 66 66 66 66 66 66 66 66 65 65 68 67 67 69 67 67 70 70 70 70 70 65 59
9 38 38 38 38 38 38 38 38 37
14 72 72 72 72 72 72 72 72 72 72 72 72 72 71
0
1 2
10 74 74 74 74 74 74 74 74 74 73
0
