26
77 4 4 4 4 4 4 4 4 4 4 7 7 7 7 7 5 5 9 9 9 9 9 9 9 9 9 4 4 4 4 4 4 4 4 4 4 4 4 4 4 4 4 4 4 4 4 4 12 10 10 14 10 10 16 16 16 16 16 10 10 18 18 18 18 18 10 10 20 20 20 20 20 20 20 20 20 4
17 23 23 24 23 23 23 26 26 26 26 26 26 25 25 28 25 22
35 30 30 31 31 31 31 31 31 31 31 31 30 30 30 33 33 33 33 33 32 32 35 35 35 35 35 35 35 35 35 34 34 36 32 29
24 38 38 38 38 38 38 39 39 39 39 38 38 38 41 40 42 42 42 42 42 42 42 42 42
23 45 45 45 45 46 45 45 45 48 48 48 48 48 48 47 47 50 50 50 50 50 47 44
28 52 52 52 52 53 53 53 53 53 53 53 53 52 52 52 55 55 55 55 55 54 54 57 56 56 58 54 51
15 60 60 60 60 60 60 60 60 61 60 60 60 63 62 64
16 67 67 67 67 67 67 68 68 68 68 68 67 67 67 69 66
17 71 71 71 71 71 71 71 71 71 71 72 71 71 71 74 73 75
22 78 78 78 78 78 78 78 78 79 78 78 78 82 81 81 84 83 83 85 81 80 77
23 87 87 87 87 87 87 87 87 88 87 87 87 91 91 91 91 91 90 89 89 89 92 86
26 94 94 94 94 94 94 94 94 95 95 95 95 95 94 94 94 97 96 96 96 99 98 98 101 98 93
26 103 103 103 103 103 103 103 103 104 103 103 103 106 106 106 106 106 105 105 105 108 107 107 110 107 102
26 112 112 112 112 112 112 112 112 113 113 113 113 113 112 112 112 115 115 115 115 115 114 114 114 116 111
13 71 71 71 71 71 71 71 71 71 71 71 71 70
31 118 118 118 118 118 118 119 119 119 119 118 118 118 122 122 122 122 122 121 121 121 123 123 123 123 123 120 120 120 124 117
41 126 126 126 126 126 126 128 128 128 128 128 128 128 128 127 127 130 129 129 131 127 126 126 126 134 134 134 134 134 133 133 136 133 132 132 132 137 137 137 137 125
11 60 60 60 60 60 60 60 60 60 60 59
21 139 139 139 139 140 140 140 140 140 139 139 139 141 141 141 141 141 141 141 141 138
49 143 143 143 143 145 145 145 145 145 145 145 145 145 144 144 147 147 147 147 144 143 143 143 149 149 149 149 149 149 149 149 149 149 149 148 148 151 150 150 152 150 150 153 153 153 153 153 148 142
9 38 38 38 38 38 38 38 38 37
14 155 155 155 155 155 155 155 155 155 155 155 155 155 154
0
1 2
10 157 157 157 157 157 157 157 157 157 156
0
